######################
#  > ####   ##@     #
#    ##     ####### ###
## #### #   ###  +   ##
 # #### #######/+### ##
 # ####          ### ##
 #      ###### /    +##
#####################
