 ######################
 #>   ####   ##       @#
 #    ##     ####### ###
 ## #### #   ###      ##
  # #### #######  ### ##
  # ####          ### ##
  #      ######       ##
 #####################
