######################
#  > ####   ##@     #
     ##     ####### ###
## #### #   ###      ##
 # #### #######  ### ##
 # ####          ### ##
 #      ######       ##
#####################
