######################
#  > ####   ##@     #
#    ##     ####### ###
## #### #   ###      ##
 # #### #######  ### ##
 ######          ### ##
 #      ######       ##
#####################
