######################
#    ####   ##@     #
#    ##     ####### ###
## #### #   ###      ##
 # #### #######  ### ##
 # ####          ### ##
 #>     ######       ##
#####################
