######################
#  > ####   ##@     #
#    ##     ####### ###
## #### #   ###      ##
 #~#### ####### ~### ##
 # ####          ### ##
 #      ######       ##
#####################
