######################
#  > ####   ##@     #
#    ##     ####### ###
## #### #   ###  +   ##
 # #### #######+~### ##
 # ####          ### ##
 #      ######       ##
#####################
